00 01 00 00 00 01 00 00 00 00 
01 00 01 01 01 01 01 01 01 01
01 01 01 01 00 00 00 00 00 00
02 02 02 02 03 04 03 03 02 03
00 00 00 00 00 00 00 00 00 00
03 03 03 03 03 03 03 03 03 03
04 04 04 04 04 04 04 04 04 04
